0/00/00/00/00
1/00/01/00/00
2/00/05/00/00
3/05/04/00/00
4/06/06/00/00
5/10/10/00/00
0