0/00/00/00/00
1/05/00/00/00
2/08/10/06/12
3/10/00/00/00
4/12/00/00/00
5/15/00/00/00
0